R 1280 720
NO ./textures/wood.xpm
SO ./textures/eagle.xpm
WE textures/metal
EA ./textures/brick.xpm
S ./textures/barrel.xpm
F 20, 20, 20
C 150,200,255

111111111
100000001
100000001
1000S0001
100000001
100000001
110000011
120000001
110000011
120000001
110000011 11111
120000001 12021
112020211 12221
120202021 11111
111111111